#####################
S.#.......#.....#...#
#.#######.#####.#.###
#.#...........#.#...#
#.#.#######.#.#.###.#
#.#.......#.#.#.#...#
#.#####.###.###.###.#
#.........#.........#
#####.###############
#.................#.#
###################.#
#.....#.#.#...#...#.#
###.###.#.#.#.#.###.#
#...........#.......#
#.###################
#.......#.........#.#
###.#####.#.#.#####.#
#.........#.#.#...#.#
#########.###.#.#.#.#
#...........#...#...#
###G#################
