###########S#####################################################################################################################
#...#...#.#.#.#...#.....#.#.....#.....................#.#.#.....#.....#.#...#.#.#.#.#.....#...#.#.#...........#.....#.......#...#
###.#.#.#.#.#.#.#.#.#.#.#.#.#.#.#####################.#.#.#.#.#.#.###.#.#.#.#.#.#.#.###.#.#.#.#.#.#.#.###.#.#.#.#####.#.###.#.#.#
#...#.#.#.#.#.#.#...#.#.....#.#.#...#.#.........#.#.........#.#...#.......#.....#.......#...#.#.....#...#.#.#.#.....#.#...#...#.#
###.#.#.#.#.#.#.#######.#.#######.#.#.#.#.###.###.#.#.###.###.###.#####.#.#.#.#.#.#.#######.#.#########.#######.#########.#######
#.....#.#...#.#.......#.#.......#.#.....#.#.........#.#...#.....#.....#.#.#.#.#.#.#.#.......#.#...#.........#.#.....#...........#
###.#.#.#.#.#.#.###############.#######################.#####################.#.#.#####.#####.#.###.#.#####.#.#.###.#####.#######
#...#.#...#...#.......#.........#...#...#...#.#.......#...#.......#...#...#.#.#.#...#.......#.#...#.#.#.....#.#.#...#...#...#...#
#.###########.#########.###########.#.#.#.###.#.#.###.###.#.#####.#.#.#.#.#.#.#.###########.#.#.###.#.#.#.#.#.#.#.#.#.###.#.###.#
#...#...#.#...#.#...............#...#.#.....#...#.#...#...#.#.....#.#...#...#.#.#...........#.#...#.#.#.#.#.#.#.#.#.#.....#.....#
#.#####.#.#.#.#.#######.#.#####.#.###.###.###.#.#.###.#.###.###.#########.###.#.#.#.#######.#.#.###.#.#.#.#.#.#####.###.#######.#
#...#.#.....#.#.#.......#.....#.#.#.#.#.......#.#.#.........#.....#.#.#.#...#.#.#.#.#.......#.#...#.#.#.#.#.#.#.....#.......#...#
###.#.#.#.#.#.#.#######.#######.#.#.#######.#######################.#.#.#.#.#.#.###.###.#####.#.###.#.#.###.#.###.#############.#
#...#...#.#.#.#.#.#.......#...#.#...#.#.#...#...#...#.#.#.......#.#.#.#.#.#.#.#.#...#.......#.#...#.#.#.#.#...#...#.#...........#
#.#####.#####.#.#.#####.###.###.###.#.#.#.###.#.#.#.#.#.#.#.###.#.#.#.#.#.#.#.#.#.###############.#.#.#.#.#.#.###.#.#.#########.#
#.#.#...#.....#.#.#.#.....#...#.#...#.#.......#...#.......#.#.....#.#.#.#.#.#.#.#.#.#.........#...#.#.#...#.#.#.....#.......#...#
#.#.#.###.###.#.#.#.#.#######.#.###.#.###.#########################.#.#.#.###.#.#.#.#.#####.#####.#.#.#.#.#.#.###.#.#######.###.#
#.#.#...#.#...#.#.........#...#.#...#.#.............#...#.#.....#...#.#.#.#.#.#.#.#.....#.....#...#.#.#.#.#.#.#...#.....#...#...#
#.#.#.#######.#.#.###.#######.#.###.#.#########.#######.#.#.###.#.#.#.#.#.#.#.#.#.#.#############.#.#.#.#.#.#.#####.###.###.#.#.#
#.#.#...#.......#.#.#.#...#...#.#.....#.........#.#.#...#.#.#.#...#.#.#.#...#.#.#.#...#.....#.#...#.#.#.#.#.#.#.#.#.#.......#.#.#
#.#.###.#####.#.#.#.#.#.###.#.#.#.###.#######.###.#.###.#.#.#.#.#.#.#.#.#.#.#.###.#.###.#####.#.#.#.#.#####.#.#.#.#.###.#########
#.#.#...#.....#.#.#.#.....#.#.#.#...#.#.#...#...#.#.#.........#.#.#...#.#.#.#...#.#.#.#.......#.#...#.#.....#.#.#...#.#.#.....#.#
#.#.###.###.###.#.#.#.#.###.###.#.###.#.###.#.#.#.#.###########.###.#.#.#.#.#.###.#.#.###.###############.#####.#.#.#.#.###.#.#.#
#.#.#...#.....#.#.#...#...#...#.#...#.#.......#.#.#.#.#...#.......#.#.#.#.#.#.#.#.#...#...#...#.#...#...#.....#...#.#.#.#...#.#.#
#.#.###.#######.#.#.#######.###.#.###.#####.#####.#.#.###.#.#######.#.#.#.###.#.#.###.###.###.#.#.#.#.#.#.###.#####.#.#.#.###.#.#
#.#.#.........#.#.#.......#...#.#.#.#.#.........#.#.#.#...#.......#.#.#.#...#...#.#.......#...#.#.#.#.#.....#.#.....#...#...#.#.#
#.#.#####.#####.#.#.#####.###.#.#.#.#.###.#.#.#.#.#.#.#.#######.###.###.#.###.#.#.###.###.###.#.#.#####.###.###.#####.#.#.###.#.#
#.#.#.........#.#.#.....#.#.#.#.#.#.#.#.#.#.#.#.#.#.#.....#.#...#.#...#.....#.#.#.#...#.......#.........#.....#...#.#.#.#...#.#.#
#.#.#########.#.#.#####.###.#.#.#.#.#.#.#.#.###.#.#.#.#####.###.#.#.#.#.###.#.###.#######.#################.#####.#.#.#.#.###.#.#
#...#.....#...#.#.#.#.#.#.#...#.#...#.#...#.#...#.#.#.#.#.#.......#.#.#.#...#...#.#.....#.....#.....#.#.#.#.#.#.#...#.#.#...#.#.#
#.#.#.#######.#.#.#.#.#.#.#.###.###.#.#####.#####.#.#.#.#.#.#.#####.###.###.#.###.#.#######.###.###.#.#.#.#.#.#.#.#.#.#.#.###.#.#
#.#.#.....#...#.#.#.....#.....#.#...#.#.....................#.....#.....#...#...#.#...........#.#...#.....#...#...#.#.#.#...#...#
#.#.#.#######.#.#.#.#.#.#.###.#.###.#.#########################.###.#.#.#.#.#.###.#####.#.#####.#.###.#.#.#.#.#.###.#.#.###.###.#
#.#.#.....#...#.#.#.#.#...#...#.#...#.#.............#...#.#.#...#.#.#.#.#.#.#.#.#.#...#.#.......#.....#.#...#.#...#.#.#.....#.#.#
###.###.###.###.#.#.#########.#.#.###.#.###.#########.#.#.#.#.#.#.###.#.###.#.#.#.#.###.###.#############.#######.#.#.#.###.#.#.#
#...#...#.#...#.#.#.#.#...#...#.#.#.#.#.#...#.....#.#.#.#...#.#...#...#.#...#...#.#.....#.....#...#.....#.....#...#.#.#.#...#.#.#
#.###.###.#.###.#.#.#.###.#.###.#.#.#.#.#.#####.###.#.#.#.#.#.#.#.###.#.###.###.#.#####.###.#####.#.###.#.###.#.###.#.#.###.#.#.#
#...#...#.....#.#.#.......#...#.#...#.#.#.#.#.#...#.#.#.#.#...#.#.#...#.#...#.#.#.#.#.#.#.....#.......#.....#.#.#.#.#.#.#.....#.#
###.###.#.###.#.#.#.#######.#.#.###.#.#.#.#.#.#.###.#.#.#.#.#.#############.#.#.#.#.#.#.#.###.#######.#########.#.#.#.#.###.#.#.#
#...#.....#...#.#.#.......#.#.#.#...#.#.#.........#.#.#.#.#.#.....#...#.....#.#.#.......#...#.#.............#.#...#.#.#.#...#.#.#
#.#########.###.#.###.#####.###.#.###.#.#.#.#.#####.#.#.#.#.#.#####.###.###.#.#.###########.###.#.#####.#.#.#.#.#.#.#####.#######
#.#.#...#.....#.#.#.#.....#.#.#.#...#...#.#.#...#.....#...#.#.#.#.#.#.....#.#...#.#...........#.#.#.....#.#...#.#.#.#...#.#.#.#.#
#.#.###.###.#.#.#.#.###.#.#.#.#.#.#.#.#.###.#.#.#.#.#.#.#.#.#.#.#.#.#.#.###.###.#.#.#.#####.#.#######.#########.#######.#.#.#.#.#
#...#.......#.#.#.#.#...#.#...#.#.#.#.#.#...#.#...#.#.#.#.#.#.....#...#...#.#...#...#.....#.#.#.#.......#.#.#.#.....#.#...#.#...#
###.#########.#.#.#.#.###.#.###.###########.#########################.#######.#.###.###.#.#.#.#.#####.###.#.#.###.###.#.#.#.#.#.#
#...#.....#.#.#...#.#.#.#.#...#.#.#...#.............#...#.#...#...#.....#...#.#.#...#...#.#.#.#...#.....#.......#.#.#...#.....#.#
#.#.#.#.#.#.#.#.#.#.#.#.#.#.###.#.#.#.#.#############.#.#.#.#.###.###.###.#.#.###########.#####.#.#.#.#######.#.#.#.#####.###.#.#
#.#.#.#.#...#.#.#.#.#...#.#...#.#...#.#.............#.#.#...#.....#.......#.#.#.#.............#.#...#...#.#...#.#...#...#...#.#.#
#.###.###.#.#.#.#.#.#####.###.#.#.#.#######.#########.#.#######.###.###.#.###.#.###########.###.###.#.###.#.#.#.#.#.#.#.###.#.#.#
#...#.#...#...#.#.#.......#...#.#.#...#.#...........#.#.#.........#...#.#...#.#.#...#...#...#.#.#...#...#...#.#.#.#.#.#.....#.#.#
#.#######.#################.###.#.#.###.#####.#######.#.#########.#.#########.#.###.#.#.#.#.#.#.#.#####.#####.#.#.#.###.#########
#...#.........#...............#.#.#.#.#.#.#.#.#.....#.#.#...#.....#.........#...#.....#...#.#.#.#...#...#.#...#...#.#...........#
#.###.###.#################.###.#.#.#.#.#.#.#.#.###.#.#.#.#.###.#####.#####.#.#.#########.###.#.#####.###.#.###.#.#.#.#####.#.#.#
#...#.#.#.#.#.#.#.............#.#.#...#.#.......#...#.#...#.#.....#.#.#.....#.#.#.#.........#.#.#.......#.#...#.#.#.#.#.#.#.#.#.#
###.#.#.#.#.#.#.#.#.#######.###.#.#.###.###########.#.###.#.###.###.#.#####.###.#.#.#.#.#.#.#.#.#######.#.###.#.#.#.#.#.#.#.#.#.#
#...#.#.......#...#.#.........#...#.....................#.#.......#...#.....#.....#.#.#.#.#.#.#.#.....#.......#.#.#.#.#.....#.#.#
#.###.#.#.###.###.#################.###############################.#.#.#.###.###.#.#######.#.#.#.#.###.#.###.#.#.#.#######.#####
#.#.#.#.#.#...#.............#...#.........#.......................#.#.#.#...#...#...#.........#.#.#.....#.#...#.#.#.#.....#.....#
#.#.#.#####.###.###.#.###.#.#.#.#.#.#####.#.#.#######.#.#.#.#.###.#.#######.###.#.#.#.#####.#.#.#.#.###.#.#.###.#.#.#.###.#.###.#
#...#.#.......#.#...#.#...#...#.#.#.#.......#.......#.#.#.#.#.#...#...#.....#...#.#.#.....#.#.#.#.#...#.#.#...#.#.#.#...#...#...#
###########################################################################.#####################################################
#.......#.#.#...#.#.#.#.#.#.#.#...#.#.........#.......#...........#.........#.....#.#.#...#.#.....#.#...#.#.....................#
###.#####.#.#.#.#.#.#.#.#.#.#.#.###.###.###.#.###.#####.#########.###.###########.#.#.###.#.###.#.#.#.#.#.#.#.#######.#.#.#.#.#.#
#.......#.....#...#...#.#.#.#.#.....#.....#.#.#.......#.#.........#.........#.....#...#...#.....#.....#.....#.#.......#.#.#.#.#.#
#######.#.#.#########.#.#.#.#.#.###.#.###.#.#.#######.#.#.#.#####.#########.#.#.###.#.###.#####################.#################
#.........#...#.#.#.........#.....#.....#.#.#...........#.#.#.....#.........#.#.....#.#...#...#.#...#.#...........#.#.#.#.#.....#
###.#####.#.#.#.#.###.###.###############################.#########.#.#.#.#.#.#########.###.###.#.#.#.#########.#.#.#.#.#.#.#.#.#
#...#...#.#.#.........#...#.#.......#.#.#.#.....#...........#.#...#.#.#.#.#.#.....#...#...#...#.#.#.#...........#.....#.#...#.#.#
#.#.#.###########.###.#.###.###.#####.#.#.#####.#.###.#####.#.###.#.#.#.#.#.#.#####.###.###.###.#.#.#.###.#############.#.#.#.#.#
#.#.....#.........#...#.....#.......#.#...#.....#...#.....#...#.#.#.#.#.#.#.#.....#.#.#...#.....#.#...#...........#...#.#.#.#.#.#
#############.#####################.#.#.#.###.#######.#########.#.#######.#####.###.#.#.#######.#.#.#.#########.#####.#.#.#####.#
#.#.#...........#...........#.......#.#.#...........#.........#...#.........#.....#...#...........#.#.#.....#.#...#...#.#.#.....#
#.#.#######.###########.#####.#.#.###.#.#.###.#####.###.#####.###.#.#############.#.#####.#.#.###.#.#.###.###.#.#.#.###.#.###.###
#.#.#.....#.#.#.#.......#...#.#.#.......#.#.....#...........#.....#.#.#.#.........#...#...#.#...#.#.#.#.........#.....#...#...#.#
#.#.###.#.#.#.#.#####.###.#################.#######################.#.#.#.#.#####.#.###.#########.#########.#######.###.#.#.###.#
#...#...#...#.#.#...........#.....#.#.#.....#.#.#.......#...#.#...#.......#.#.....#.......#.....#...#.#...........#.....#.#.....#
#.#.###.###.#.#.#.#####.#.#.#####.#.#.#.#####.#.#.#.###.#.#.#.#.#.#########.###.#.#.###.#####.#####.#.###############.#.#.#.#####
#.#.#.....#...#.#...#...#.#.#.....#.#.#...........#...#.#.#.....#.#.#...#...#...#.#...#...#.....#.#.#.#...............#.#.#.....#
#.#.#.#.###.#.#.#######.#.#.###.###.#.###.###.#.#.###.#.#.#.#####.#.#.#.#.#.###.###.#.#.#######.#.#.#.#######.#########.#.#.#####
#.#...#...#.#...........#.#.................#.#.#.#...#...#.....#.#...#...#.#.......#.#...#.......#...#...............#.#.#...#.#
#.#.#######.###################################################.###########.#########.#.#######.#.#.#.#############.###.#.#.#.#.#
#.#.#.......................#.............#...#.#.#...............#.#.#.#...#.........#...#.#...#.#.#.#.............#.#.#.#.#...#
#################.###########.###.#####.###.#.#.#.#####.#########.#.#.#.#.#####.#########.#.#.#.#.#.#.###.###########.#.#.#.#####
#.#.....#.#.#.......#.....#.#.#...#.......#.#.#.#.#.....#...#.#.#.#.#.#.....#.........#...#...#.#...#.#.#.#.#.#.....#.#.#.#.....#
#.#####.#.#.#.#.###.#.#.#.#.#.###.#######.#.#.#.#.#.#####.###.#.#.#.#.#.###.#.#####.#.###.###.#.#####.#.#.#.#.#.#####.#.#.###.###
#...........#.#...#.#.#.#.#.#.#...#.........#...#.#.....#.#.......#.#.#.#...#.....#.#.#.#.#...#.#.....#.......#.......#.#.#.#.#.#
#########.###.#####.#.#.#.#.#.###################.#####.#.#.#.#.#.#.#.#.#############.#.#.###.###########.#####.#####.#.#.#.#.#.#
#.............#.#.#.#.#.#.#.#.#.#.#.#...#.#.#.#.#.#.#.#.#...#.#.#.#.#.#.....#...#.#.#.#...#...#.#.....#.............#.#.#.#.....#
#########.###.#.#.#.#.#.#.#.#.#.#.#.#.#.#.#.#.#.#.#.#.#.#########.#.#.#####.#.#.#.#.#.#.#.#.###.#.###.#####.###########.#####.#.#
#.......#...#.#.......#.#.#.#.........#.#.#...#.#.......#.#.#.#...#.#.......#.#.#.#...#.#.#.....#.#...#.#.#.#.........#...#...#.#
#.###.#.#.#.#.#####.#.#.#.#.#.###.#.#.#.#.#.#.#.#.#####.#.#.#.#.###.#.###.###.#.#.#.#.#.###.#####.###.#.#.#.#.###.###.#.#####.###
#...#.#...#.#.#.#...#.#.#...#...#.#.#.#...#.#...#.#.....#.........#.#.#.....#.#.....#.#.#.#.....#.#...#.....#.#...#...#.#.#...#.#
#.###########.#.#.###.#.#.#.#.#########.###.#.#######.#####.#######.#.#.###########.###.#.#.#####.#.###.#.#.#.###.#####.#.#.#.#.#
#.#.........#.#.#...#.#.#.#.#...#...........#...#.......#.............#.....#.....#...#.#.#.....#.#...#.#.#.#.#.....#.#...#.#...#
#.#####.#####.#.###.#.#.#.#.#.#.###.#####.#.###.###.#####.#########.#.#.#######.#.###.#.#.#.#.###.###.#.#.#.#.###.#.#.###.#.#.#.#
#...........#.#.....#.#.#.#.#.#.#.....#...#.#...........#.........#.#.#.....#...#.....#...#.#.....#...#.#.#...#...#...#...#.#.#.#
###############################G#################################################################################################
