###############################
#...............#.........#.#.#
###.#########.#####.#######.#.#
#...#.........................#
###################.###########
#.........#.#...#...#.#.....#.#
#.#####.#.#.#.###.###.#.###.#.#
#.#...#.#.#.#...#...#.#...#...#
#.#.#.#.#.#.#.#.###.#.#######.#
#.#.#...#.#...#.#...#.#.......#
#.#########.#.#.#.###.#.###.#.#
#...#.#.#.#.#.#.#.#.#.....#.#.#
###.#.#.#.###.###.#.#.#.#######
#.......#.#...........#.......#
###.#.#.#.#######.#############
#...#.#...........#.......#...#
#.###.###.#.###.#########.###.#
#...#...#.#.#.................G
#####.#########################
#.......#.....................#
#.#################.###########
#...........#.#...#...#.#.....#
#.#######.#.#.###.#.#.#.###.#.#
#...#.#.#.#...#...#.#...#...#.#
###.#.#.#.###.###.#.#.#.###.#.#
#...#.#.#.#.........#.#.#.#.#.#
#.###.#.#.#####.#####.###.#.#.#
#...#...#.....#...#.....#...#.#
#.#.#.#.#######.###########.#.#
S.#...#.#...................#.#
###############################
